{
    "levels": [
        {
            "name": "Super easy",
            "data": [
                "##,,,##",
                "#######",
                "#~..$~#",
                "#..~..#",
                "#.$.$.#",
                "#.@.$~#",
                "#######"
            ]
        },
        {
            "name": "Tutorial",
            "data": [
                "#####,,",
                "#@..#,,",
                "#.#$###",
                "#.$.~~#",
                "#######"
            ]
        },
        {
            "name": "Easy",
            "data": [
                ",,,,#####",
                ",,,,#..@#",
                "###,#$$.#",
                "#~#,#.$.#",
                "#~###.###",
                "#~.....#,",
                "#..#...#,",
                "####...#,",
                ",,,#####,"
            ]
        },
        {
            "name": "Corners",
            "data": [
                "#######",
                "#~...~#",
                "#.$@$.#",
                "#.###.#",
                "#.$.$.#",
                "#~...~#",
                "#######"
            ]
        },
        {
            "name": "Airplane",
            "data": [
                "########",
                "#~..$.~#",
                "#~$$$$~#",
                "#~.@$.~#",
                "########"
            ]
        },
        {
            "name": "Stripe",
            "data": [
                "########",
                "#~....~#",
                "#@$$$$.#",
                "#~....~#",
                "########"
            ]
        },
        {
            "name": "Arrow",
            "data": [
                "#########",
                "#...*...#",
                "#.$~#~$.#",
                "#..$~$..#",
                "###~$~###",
                ",,##@##,,",
                ",,,###,,,"
            ]
        },
        {
            "name": "Underground",
            "data": [
                ",#########",
                "##.......#",
                "#...#$#$.#",
                "#.$$..~$~#",
                "#.@###~~~#",
                "####,#####"
            ]
        },
        {
            "name": "Ring",
            "data": [
                "#######",
                "#~.~.~#",
                "#.$$$.#",
                "#~$@$~#",
                "#.$$$.#",
                "#~.~.~#",
                "#######"
            ]
        },
        {
            "name": "Snake",
            "data": [
                ",,,,,,####",
                "#######..#",
                "#.$.$.$..#",
                "#.~~~~~~@#",
                "#..$.$.$.#",
                "#..#######",
                "####,,,,,,"
            ]
        }
    ]
}